NO asset/textures/bk_wall.xpm       	   
SO asset/textures/bk_wall.xpm
WE asset/textures/bk_wall.xpm
EA asset/textures/bk_wall.xpm

F asset/textures/bk_floor_64x64.xpm
C asset/textures/bk_ceiling.xpm

111111111111111111111111
100000000011000000000001
101100000111000000000001
1001000000-000000000W001
10110000011100M000000001
10000000001100000111-111
111101111111111111000001
111101111010101011010101
110000001101010111000001
100000000000000011000001
100000000000000011010101
11000000110101011111011111111111111111
11110111111101111111011111000000000001
11110111111100101100000110000000000001
11000001110000001100000000000010000001
10000000110000001100000000000000000001
10000000111111101110001110000000001111
10000000111111111001010111100010001
11000001110001101010001110000000001
10000000100000110101010110000000001
10000000000000000000000110000010001111
10000000100000110101010110000000001001
11000001110001101010001110000000001001
11110011111111111111111111110011111001
10000000001000000000100000000001000001
10000000000000000000100000000000000001
10010000000000000000100000000001000001
10000000001000000000100000000001111111
10000000001000000000100000000001
10010000001000000000100000000001
10000000001000000000100000000001
10000000001000000000100000000001
10010000001111111111100000000001
10000000001000000000000000000001
10000000000000000000000000000001
10010000001111111110000000000001
10000000000000000110000000000001
10000000000000100110000000000001
10010000000000000110000000000001
10000000000000100110000000000001
10000000000000000110000000000001
11111111111111111111111000011111
                      1111111