NO asset/textures/bk_wall.xpm
SO asset/textures/bk_wall.xpm
WE asset/textures/bk_wall.xpm
EA asset/textures/bk_wall.xpm

F asset/textures/bk_floor_64x64.xpm
C asset/textures/bk_ceiling.xpm

111111111111111111111111
100000000011000000000001
101100000011000000000001
1001000000-0000M0000W001
101100000111000000000001
10000000001100000111-111
111101111111111111000001
111101111010101011010101
110000001101010111000001
100000000000000011000001
100000000000000011010101
110000001101010111110111
111101111111011111110111
111101111111001011000001
110000011100000011000001
100000001100000011000001
100000001111111011100011
100000001111111110010101
110000011100011010100011
100000001000001101010101
100000000000000000000001
100000001000001101010101
110000011100011010100011
11111111111111111111111
