NO asset/textures/bk_wall.xpm
SO asset/textures/bk_wall.xpm
WE asset/textures/bk_wall.xpm
EA asset/textures/bk_wall.xpm

   C asset/textures/bk_wall.xpm
  F asset/textures/bk_wall.xpm  

1111111111
1011111111
1001111111
1100000S01
1101111111
1111111111