NO asset/textures/tests/simonkraft/basalt_top.xpm
			SO asset/textures/tests/simonkraft/basalt_top.xpm
	WE asset/textures/tests/simonkraft/basalt_top.xpm
	
	EA asset/textures/tests/simonkraft/basalt_top.xpm

F 64, 64, 64
C asset/textures/so_long_player.xpm

     11111111111
     10000000011
 111100000000001
 1000000000W0011
 101100000000001
 1-1 10000000011
1000111111111111
10001
10001
10001
10001
10M01
10001
11111
